################################################
#                                              #
#     ########                                 #
#            #                                 #
#            #                   #      ###    #
#            #         @         #             #
#            #                   #             #
#                                #             #
#                                #             #
#                   ##############             #
#                                              #
#                                              #
################################################